aaaaaaaaaaaaaaaaaaaaaaaaaaa
200000002000200000200000002
222222202020202220202022202
400000004040404040404040404
333333303030303030303030303
700000000070707000707000707
606060606060606666606666606
909090909090900000000000009
909090909080888888888888808
505050505050500000000000005
505050505550505555555555555
505000500000500000000000005
a0aaaaaaaaa0aaaaaaaaaaaaa0a
a000000000a000000000000000a
aaaaaaaaa0aaaaaaaaaaaaaaaaa
a00000000000a0000000000000a
a0aaaaa0a0a0a0aaa0aaaaaaa0a
a0a000a0a0a0a0a0a0a00000a0a
a0a0a0a0a0a0a0a0a0aaaaa0a0a
a0a0a0a0a0a0a0a0a0000000a0a
a0a0a0a0a0a0a0a0a0aaaaa0a0a
a0a0a0a0a0a0a0a0a0a00000a0a
a0a0a0a0a0aaa0a0a0aaaaaaa0a
a0a0a0a0a00000a00000000000a
a0a0aaa0aaaaaaaaaaaaaaaaaaa
a0000000000000000000000000a
aaaaaaaaaaaaaaaaaaaaaaaaaaa
