111111111111111
110010100101011
100101010100111
100010101100001
111111111111111
